width:20
height:20
mazeX:3
mazeY:9
starX:0
starY:-6
.#....#..........##P
...##.#....#####....
.###..####.....#####
...#.##...####.....#
##.#....#....#####..
...##.######.....##.
.######....#####....
........##.....#####
#############.#.....
#...#...#...#...###.
#.#...#...#.####....
..########.......##.
.##......###########
....####.#..........
.###...#.#.#######.#
###..#...#.#.....#..
.#..#####..#.###.##.
...##.....##..#..#..
.###..#######.#.##.#
.....##@......#.....