width:19
height:19
mazeX:0
mazeY:6
starX:0
starY:-6
@....#....#........
####.#.##..#..####.
.....#..##...#.....
.######.#.###..####
......#.#.....#....
#####.#.#.####...#.
....#.#.#......###.
.#..#...#.....##.#.
.#.###########...#.
.#.#...........#.#.
.#...###########.#.
.#.##.....#...#..#.
.###......#.#.#....
.#...####.#.#.#####
....#.....#.#......
####..###.#.######.
.....#...##..#.....
.####..#..##.#.####
........#....#....P