width:13
height:16
mazeX:0
mazeY:0
starX:-2.25
starY:4.6
....#........
.##.#.#.#####
..#...#......
#.##########.
..#.......#..
.##.#####.#.#
..#.....#.#..
#.#####.#.##.
..#.@#P.#.#..
.##.#####.#.#
..#.....#.#..
#.#####.#.##.
..#...#.#.#..
.##.#.#.#.#.#
.##.#.#.#.#..
....#...#....