width:20
height:17
mazeX:9
mazeY:3
starX:0
starY:-6
.................###
P#####......#####...
#......#####......#.
..#####......#####..
.#......#####......#
...#####......#####.
###......#####......
....#####......####.
.###......#####.....
.....#####......####
#####......#####....
......#####......##.
.#####......#####...
.......#####......##
..#####......#####..
##......#####......#
...####........###.@