width:20
height:17
mazeX:3
mazeY:6
starX:0
starY:-6
####################
#........#.........#
#.######.#.#######.#
#.#......#.......#.#
#.#.############.#.#
#.#.#....#.....#.#.#
#.#.#.##.#.###.#.#.#
#.#...#......#.#.#.#
#.#######....#...#.#
#.#...#.@#########.#
#.#.#.#.#P.......#.#
#.#.#...#......#.#.#
#.#.############.#.#
#.#.....#........#.#
#.#####.#.########.#
#.......#..........#
####################