width:17
height:17
mazeX:3
mazeY:2
starX:0
starY:-6
.................
.###############.
.#.............#.
.#.###########.#.
.#.#.........#.#.
.#.#.#######.#.#.
.#.#.#.....#.#.#.
.#.#.#.###.#.#.#.
.#.#.#.#@#.#.#.#.
.#.#.#.#...#.#.#.
.#.#.#.#####.#.#.
.#.#.#.......#.#.
.#.#.#########.#.
.#.#...........#.
.#.#############.
.#...............
P################