width:11
height:14
mazeX:0
mazeY:0
starX:0
starY:-6
.....#.....
##.#.#.#.#.
...#.#.#P..
.###.#.###.
...#.#.....
##.#...####
...#..#....
.####.#.##.
...#..#..#.
##.#.###.#.
...#.....#.
.#########.
.@#...#....
....#...#..